R____________________________________________________________________________________________________________T
                                                                                                             |
    E    6                           3                                         2                             |
                                                                                                             |
                   ______                          ______  ______                          ______            |
|                ||                                      ||                                      ||          |
|                ||                                      ||                                      ||          |
|                ||______                          ______||______                          ______||          |
|                ||                                      ||                                      ||          |
|                ||                                      ||                                      ||          |
|                ||______                          ______||______                          ______||          |
|                ||                                      ||                                      ||          |
|                ||                                      ||                                      ||          |
|                ||______                          ______||______                          ______||          |
|                ||                                      ||                                      ||          |
|                ||                                      ||                                      ||          |
|                ||______                          ______||______                          ______||          |
|                ||                                      ||PPPPPPPP                      PPPPPPPP||          |
|                ||                                      ||PPPPPPPP                      PPPPPPPP||          |
|                ||______                          ______||______                          ______||          |
|                                                                                                   _________|
|       5                            4                                         1                   G S    
|                                                                                                  G         
L____________________________________________________________________________________________________________J